#######################
#.....................#
#.###.............###.#
#.#.................#.#
#.#.................#.#
#.....................#
#........#####........#
#.....................#
#.....................#
#........#####........#
#.#.................#.#
#.#.................#.#
#.###.............###.#
#.....................#
########################