##########...##########
#.....................#
#.....##.......##.....#
#.#.................#.#
#.#.................#.#
#.........###.........#
.......................
...###...........###...
.......................
#.....................#
#.#.................#.#
#.#.....#######.....#.#
#.....................#
#.....................#
##########...##########