###.###..#######...####
....#......#...........
....#......#...........
#...#......#...........
#...#......#...........
#..........############
#.....................#
#.....................#
#.....................#
#######..#####........#
#.....#....#..........#
......#....#...........
#.....#...........###..
#.....#...............#
###.###..########...###